11111111111111111111
1P010000111100000C11
10C001101100011E0011
1111001000000C111C11
1C0001C01100100C1001
11111111111111111111