1111111111111
100100E000001
100P0111110C1
1000110000011
1111111111111