11111111111111111111111111111111111111111111111111
100000100C000000000110000010010000000010000000C011
1000000000010000000110000C001000000001000000001001
10000010000010000000010000000000000000000000100001
10000000000000000000000000000000000000000010001001
100000100000100C0000000000000000000000000010000001
10000000000010000000000000000010001000100000000001
10000000100010000011000000000000001000000000000001
10000000000000000000000100000000000000000000000001
10000000100000000000000000010000000010100000000011
100000000000000000010001010000E0000000110000000101
1C0C0000000000000000000000000000000000000000000001
1000C00000010000000100000000000000010000000C000001
1000100000000010000100001
11111111111111111111111111111111111111111111111111