111111111111111
111C000011111P1
111011101111101
1E0000000000001
111111101111111
1111000C1111111
111111111111111
