1111111111
1000000P01
1000000001
1000000E01
1111111111